#####################
#                   ##
#                    ##
#     ##              ######################
#    #      # O  #                #X       #
#    #O#    #    #                #        #
#      #    #    #                #        #######
#           #  X #                        O P   X#
#           #    #                         #######
############################################